snheghai	CCV-CV
toto	CV-CV
nghetsha	CV-CV
lhiizhe	CV-CV
rizo	CV-CV
niima	CV-CV
kadae	CV-CV
snarai	CCV-CV
kxiitshai	CCV-CV
kxanhii	CCV-CV
thwhair*ae	CCV-CV
thiidae	CV-CV
taisa	CV-CV
maetsho	CV-CV
nailha	CV-CV
tair*ai	CV-CV
nlodhai	CCV-CV
demho	CV-CV
shetshe	CV-CV
shiimhii	CV-CV
nraithai	CCV-CV
nghor*ae	CV-CV
mithai	CV-CV
ksaiwhai	CCV-CV
lhaimii	CV-CV
thonhai	CV-CV
smaedhae	CCV-CV
snitshai	CCV-CV
nhaiwi	CV-CV
dhonha	CV-CV
thidae	CV-CV
naezhii	CV-CV
kaesai	CV-CV
nger*ii	CV-CV
zhaite	CV-CV
miili	CV-CV
smhaisai	CCV-CV
nghosha	CV-CV
tsiiki	CCV-CV
saigha	CV-CV
shozii	CV-CV
kthati	CCV-CV
mato	CV-CV
whiilhe	CV-CV
taenhae	CV-CV
tshainae	CV-CV
whaidhai	CV-CV
nriiwhai	CCV-CV
thwhaka	CCV-CV
gaidhae	CV-CV
lhaelhii	CV-CV
tshaishi	CV-CV
ghailae	CV-CV
nhiidhii	CV-CV
mraenghii	CCV-CV
waishae	CV-CV
xor*ii	CV-CV
ngiimhe	CV-CV
mrighe	CCV-CV
riizhae	CV-CV
daisae	CV-CV
dhatho	CV-CV
nrina	CCV-CV
zhemhe	CV-CV
ngadai	CV-CV
salo	CV-CV
zhaeghae	CV-CV
whizai	CV-CV
ngiiwo	CV-CV
nghiixi	CV-CV
whiizhe	CV-CV
maixi	CV-CV
tshiiro	CV-CV
ridai	CV-CV
mailae	CV-CV
nainae	CV-CV
mronghi	CCV-CV
r*aenghae	CV-CV
waer*e	CV-CV
lhaighae	CV-CV
mr*iinghi	CCV-CV
raetae	CV-CV
smaelhe	CCV-CV
tiirii	CV-CV
kxaeni	CCV-CV
zhenho	CV-CV
niwii	CV-CV
ghaiwhae	CV-CV
tshaito	CV-CV
tsadhai	CCV-CV
zhaizhe	CV-CV
waingo	CV-CV
snhomai	CCV-CV
smhithi	CCV-CV
kthonai	CCV-CV
r*iino	CV-CV
gaingae	CV-CV
r*eme	CV-CV
mr*ara	CCV-CV
shizhai	CV-CV
snhaeshae	CCV-CV
lalho	CV-CV
tser*e	CCV-CV
tsaezho	CCV-CV
mraer*ai	CCV-CV
zhainai	CV-CV
naexo	CV-CV
taenai	CV-CV
ghaetshii	CV-CV
miwhi	CV-CV
nhathai	CV-CV
ngiitshai	CV-CV
ngaitai	CV-CV
gingo	CV-CV
mhamii	CV-CV
snair*e	CCV-CV
taeto	CV-CV
mr*ono	CCV-CV
range	CV-CV
smaitshai	CCV-CV
toke	CV-CV
r*aido	CV-CV
xawai	CV-CV
lhaige	CV-CV
nhaetshii	CV-CV
snidii	CCV-CV
sminhi	CCV-CV
r*atshe	CV-CV
mrige	CCV-CV
mlaixe	CCV-CV
ngaedhae	CV-CV
ksainghai	CCV-CV
nlomo	CCV-CV
thwhainghai	CCV-CV
shengi	CV-CV
thwhiitha	CCV-CV
giidhai	CV-CV
zelhii	CV-CV
taidhe	CV-CV
r*aide	CV-CV
snora	CCV-CV
tshaigai	CV-CV
nghaelhe	CV-CV
ksailai	CCV-CV
tiwe	CV-CV
mringai	CCV-CV
mrothai	CCV-CV
mhainai	CV-CV
mrezhai	CCV-CV
whiiwhae	CV-CV
dota	CV-CV
lhaizai	CV-CV
segai	CV-CV
kaelhe	CV-CV
kxair*e	CCV-CV
tsaxo	CCV-CV
tsiili	CCV-CV
snaenhae	CCV-CV
smhanhii	CCV-CV
smaitshi	CCV-CV
nremi	CCV-CV
kxainghe	CCV-CV
ksima	CCV-CV
mrelhe	CCV-CV
tiizhae	CV-CV
ngaer*ae	CV-CV
zaekai	CV-CV
smhaithi	CCV-CV
lhaer*ii	CV-CV
raeshae	CV-CV
dhisi	CV-CV
thwhingi	CCV-CV
thwholhii	CCV-CV
wiwai	CV-CV
mr*ailha	CCV-CV
disai	CV-CV
thwhaigo	CCV-CV
gaeshae	CV-CV
waimhai	CV-CV
snighe	CCV-CV
tshowhai	CV-CV
kaer*ii	CV-CV
daikai	CV-CV
zaire	CV-CV
daimai	CV-CV
nraetshe	CCV-CV
todae	CV-CV
dhaigii	CV-CV
kthomhe	CCV-CV
tshaixa	CV-CV
nlawai	CCV-CV
lhaedha	CV-CV
xaisai	CV-CV
gainghii	CV-CV
ksolha	CCV-CV
mlatai	CCV-CV
nghainai	CV-CV
mhatsha	CV-CV
tshilhai	CV-CV
zhego	CV-CV
r*aiwae	CV-CV
nhaighae	CV-CV
snaelhae	CCV-CV
whomai	CV-CV
taelhe	CV-CV
tenhai	CV-CV
whaigae	CV-CV
nghenghae	CV-CV
thwhonghai	CCV-CV
taiwai	CV-CV
tidhai	CV-CV
daingho	CV-CV
lhiinghai	CV-CV
nhaezai	CV-CV
daighai	CV-CV
mlaimai	CCV-CV
solhe	CV-CV
mr*odho	CCV-CV
snhanhae	CCV-CV
zholhai	CV-CV
thotha	CV-CV
nhaighai	CV-CV
r*othi	CV-CV
nheze	CV-CV
ghaise	CV-CV
tsar*e	CCV-CV
nanghi	CV-CV
ksawii	CCV-CV
nhegii	CV-CV
snhaigae	CCV-CV
ngalha	CV-CV
mainae	CV-CV
nilho	CV-CV
shaesho	CV-CV
thwhiga	CCV-CV
dhaeme	CV-CV
nhaer*ii	CV-CV
zaeza	CV-CV
kthanho	CCV-CV
kthaeshii	CCV-CV
nlailhii	CCV-CV
smaisii	CCV-CV
thoghii	CV-CV
whaizai	CV-CV
nasha	CV-CV
whaingai	CV-CV
thwhaesha	CCV-CV
kthaithe	CCV-CV
lhixa	CV-CV
zaedo	CV-CV
tango	CV-CV
kaina	CV-CV
ditshae	CV-CV
notai	CV-CV
lidhe	CV-CV
tshemha	CV-CV
whinghi	CV-CV
kxaisi	CCV-CV
nraewho	CCV-CV
r*izha	CV-CV
nghair*ae	CV-CV
zhiigha	CV-CV
xiitho	CV-CV
wor*e	CV-CV
xewha	CV-CV
r*iimhai	CV-CV
ksiisha	CCV-CV
mringho	CCV-CV
xolhae	CV-CV
nliiri	CCV-CV
nar*ae	CV-CV
whangho	CV-CV
dhaimo	CV-CV
smhiisa	CCV-CV
lhaengo	CV-CV
snhaighai	CCV-CV
nheghai	CV-CV
kthaiwha	CCV-CV
zhigai	CV-CV
shexe	CV-CV
tsaizo	CCV-CV
zhiixi	CV-CV
smhawhe	CCV-CV
nr*aewhi	CCV-CV
nlaetshai	CCV-CV
tsidha	CCV-CV
woghai	CV-CV
mr*iitai	CCV-CV
waila	CV-CV
naidhai	CV-CV
xasho	CV-CV
tilho	CV-CV
riilo	CV-CV
nliine	CCV-CV
nemii	CV-CV
waishe	CV-CV
thwhigho	CCV-CV
metshe	CV-CV
tazhi	CV-CV
ghainga	CV-CV
linghai	CV-CV
thwhodho	CCV-CV
thwhenge	CCV-CV
shedai	CV-CV
modhii	CV-CV
zozhe	CV-CV
mlair*e	CCV-CV
rera	CV-CV
ghiikae	CV-CV
zhir*o	CV-CV
raighi	CV-CV
nriitsho	CCV-CV
naixe	CV-CV
dhikii	CV-CV
medhii	CV-CV
nghekai	CV-CV
zhiwa	CV-CV
snigha	CCV-CV
waezii	CV-CV
kxiir*o	CCV-CV
ngaigai	CV-CV
tsholhae	CV-CV
gighii	CV-CV
giiti	CV-CV
lhesi	CV-CV
zhono	CV-CV
nlinhi	CCV-CV
saer*ai	CV-CV
dhaza	CV-CV
niwhai	CV-CV
shaixae	CV-CV
tshaitshi	CV-CV
nghile	CV-CV
thethi	CV-CV
nr*engai	CCV-CV
nginghai	CV-CV
dhese	CV-CV
shamha	CV-CV
tsawo	CCV-CV
ksiiwhai	CCV-CV
kxaidai	CCV-CV
mige	CV-CV
smhingai	CCV-CV
tiinha	CV-CV
snhair*e	CCV-CV
thwhorae	CCV-CV
mhaitshai	CV-CV
wotai	CV-CV
smaike	CCV-CV
nghilo	CV-CV
mrewo	CCV-CV
tshaewhae	CV-CV
mr*ozhai	CCV-CV
tsakii	CCV-CV
snoge	CCV-CV
thwhaizha	CCV-CV
ghize	CV-CV
nraege	CCV-CV
ksainho	CCV-CV
ngongii	CV-CV
kthetai	CCV-CV
xoshe	CV-CV
snaighe	CCV-CV
snaidho	CCV-CV
nhanhai	CV-CV
zhaigho	CV-CV
snishae	CCV-CV
mr*amii	CCV-CV
snhaezhae	CCV-CV
tshotii	CV-CV
kanghii	CV-CV
tsalhai	CCV-CV
nganghii	CV-CV
shaekai	CV-CV
kthair*ai	CCV-CV
mrowhe	CCV-CV
smhiizhai	CCV-CV
mronghe	CCV-CV
thwhiiwi	CCV-CV
ghiiwhae	CV-CV
raesi	CV-CV
kaitshae	CV-CV
thwhaedhai	CCV-CV
ksaxi	CCV-CV
ksailhe	CCV-CV
shiizii	CV-CV
sidai	CV-CV
smhaino	CCV-CV
nr*ikai	CCV-CV
mhoza	CV-CV
maeno	CV-CV
tshadho	CV-CV
kxiizhai	CCV-CV
nlitai	CCV-CV
mr*aeshai	CCV-CV
ghaino	CV-CV
tiiwhe	CV-CV
thwhainhi	CCV-CV
maize	CV-CV
thwhoza	CCV-CV
r*iizho	CV-CV
nghiita	CV-CV
thishii	CV-CV
xainhai	CV-CV
whaidai	CV-CV
theti	CV-CV
denii	CV-CV
tsaitii	CCV-CV
sidhe	CV-CV
nghiiri	CV-CV
nliti	CCV-CV
kxishe	CCV-CV
ksaiwae	CCV-CV
mr*ite	CCV-CV
lhiingai	CV-CV
thaena	CV-CV
mraide	CCV-CV
xaixa	CV-CV
lhiidho	CV-CV
mralhi	CCV-CV
thwhaiwo	CCV-CV
nhairo	CV-CV
ghaidhai	CV-CV
nritshai	CCV-CV
thakae	CV-CV
ksomai	CCV-CV
thaezae	CV-CV
ksaithae	CCV-CV
snonghae	CCV-CV
rema	CV-CV
ngimi	CV-CV
nr*iiwho	CCV-CV
snaixai	CCV-CV
thwhaedhae	CCV-CV
shar*o	CV-CV
xir*ii	CV-CV
nr*amhe	CCV-CV
nlamii	CCV-CV
nghiwi	CV-CV
mlarai	CCV-CV
lhainhai	CV-CV
nlaidai	CCV-CV
naidhii	CV-CV
smhaima	CCV-CV
dhoghai	CV-CV
smher*i	CCV-CV
nlesho	CCV-CV
r*aigae	CV-CV
ksite	CCV-CV
mlaenghai	CCV-CV
saxe	CV-CV
ksegii	CCV-CV
sasha	CV-CV
nraisi	CCV-CV
dhawhai	CV-CV
der*ae	CV-CV
dhanai	CV-CV
snaingii	CCV-CV
kximhae	CCV-CV
nr*ailha	CCV-CV
nghidai	CV-CV
keni	CV-CV
katshi	CV-CV
ksonghii	CCV-CV
ksixai	CCV-CV
dhairae	CV-CV
ksegai	CCV-CV
tsarai	CCV-CV
nr*ama	CCV-CV
zhashi	CV-CV
sair*o	CV-CV
gethai	CV-CV
zhaedhai	CV-CV
ghozho	CV-CV
snhagha	CCV-CV
smiishae	CCV-CV
laedha	CV-CV
nghiizho	CV-CV
smhiinhii	CCV-CV
miima	CV-CV
liidii	CV-CV
nr*iitshe	CCV-CV
gaiki	CV-CV
mlongo	CCV-CV
zolhae	CV-CV
mlaegai	CCV-CV
smaikae	CCV-CV
smixi	CCV-CV
zhisii	CV-CV
thiiwa	CV-CV
thwhato	CCV-CV
laexe	CV-CV
nghaiwi	CV-CV
ziishi	CV-CV
taenhai	CV-CV
saki	CV-CV
kxaithae	CCV-CV
taene	CV-CV
rainho	CV-CV
kinho	CV-CV
mromhi	CCV-CV
thwhadi	CCV-CV
sheli	CV-CV
snhaiwa	CCV-CV
gonghi	CV-CV
zaghi	CV-CV
sniito	CCV-CV
tsanghii	CCV-CV
dhaimhai	CV-CV
snangho	CCV-CV
waenghe	CV-CV
tsaimai	CCV-CV
nrigae	CCV-CV
liixai	CV-CV
ghaite	CV-CV
wesi	CV-CV
r*aidhe	CV-CV
kenge	CV-CV
ksokii	CCV-CV
whaidii	CV-CV
nigae	CV-CV
nr*aeshae	CCV-CV
tshawhai	CV-CV
kthaikai	CCV-CV
thazai	CV-CV
nlaeghii	CCV-CV
waer*o	CV-CV
mrike	CCV-CV
ghiira	CV-CV
kthenghae	CCV-CV
tsithi	CCV-CV
smhaigai	CCV-CV
saewhi	CV-CV
nr*aemi	CCV-CV
xise	CV-CV
nose	CV-CV
kthezhai	CCV-CV
whaiwai	CV-CV
kthetshii	CCV-CV
mraikii	CCV-CV
taidho	CV-CV
kaighai	CV-CV
smainhii	CCV-CV
thwhainae	CCV-CV
ngaewhi	CV-CV
mr*inghii	CCV-CV
whamho	CV-CV
ghalhae	CV-CV
dhixai	CV-CV
thaeke	CV-CV
kxakii	CCV-CV
kingha	CV-CV
nhalae	CV-CV
kthithai	CCV-CV
snhaesae	CCV-CV
mraze	CCV-CV
miidii	CV-CV
kthiimhii	CCV-CV
r*oshai	CV-CV
nriir*o	CCV-CV
thaili	CV-CV
roxii	CV-CV
mr*aengai	CCV-CV
saidae	CV-CV
mailo	CV-CV
kasha	CV-CV
thwhawho	CCV-CV
minhii	CV-CV
linghai	CV-CV
nhaito	CV-CV
nheshii	CV-CV
ghose	CV-CV
r*inai	CV-CV
redi	CV-CV
smamae	CCV-CV
woshe	CV-CV
laido	CV-CV
whothe	CV-CV
sela	CV-CV
ksingae	CCV-CV
rir*ae	CV-CV
mr*aiwai	CCV-CV
mlaengi	CCV-CV
kadhai	CV-CV
smhetsha	CCV-CV
nr*iigo	CCV-CV
kxexai	CCV-CV
ghaingai	CV-CV
xita	CV-CV
saishii	CV-CV
smhaiwa	CCV-CV
lhezai	CV-CV
xolii	CV-CV
snhonga	CCV-CV
waeke	CV-CV
xorai	CV-CV
nr*aixi	CCV-CV
xaega	CV-CV
nhairai	CV-CV
zhewhi	CV-CV
snholhi	CCV-CV
kaisae	CV-CV
shaitae	CV-CV
lhainghii	CV-CV
these	CV-CV
snani	CCV-CV
mhiinghai	CV-CV
tshiishai	CV-CV
ksaiwhii	CCV-CV
tshar*ae	CV-CV
ksainii	CCV-CV
nhanai	CV-CV
liiwhi	CV-CV
nraede	CCV-CV
tiigai	CV-CV
tshasii	CV-CV
smhainghae	CCV-CV
maikii	CV-CV
lhaethai	CV-CV
mlaitae	CCV-CV
tsidai	CCV-CV
rigi	CV-CV
dhanghe	CV-CV
xiinai	CV-CV
mhaeghai	CV-CV
tsowo	CCV-CV
zhaele	CV-CV
gasae	CV-CV
tsiithi	CCV-CV
taiwae	CV-CV
taenghii	CV-CV
gegae	CV-CV
note	CV-CV
smhonhii	CCV-CV
nr*izi	CCV-CV
mhaiko	CV-CV
shinae	CV-CV
mliidhai	CCV-CV
smhiilhai	CCV-CV
nghair*ae	CV-CV
snhilho	CCV-CV
r*etsho	CV-CV
sneso	CCV-CV
nomhai	CV-CV
snhetai	CCV-CV
smhago	CCV-CV
thairai	CV-CV
taedhai	CV-CV
saisa	CV-CV
sniidai	CCV-CV
ginho	CV-CV
ger*a	CV-CV
smithi	CCV-CV
nraer*ai	CCV-CV
liwi	CV-CV
kxini	CCV-CV
thowha	CV-CV
whiwhae	CV-CV
mr*azhi	CCV-CV
tseti	CCV-CV
snaishii	CCV-CV
mhowii	CV-CV
snhazho	CCV-CV
whaima	CV-CV
nhedai	CV-CV
thair*ae	CV-CV
snhainhai	CCV-CV
winha	CV-CV
lhaezae	CV-CV
zharai	CV-CV
tsaixa	CCV-CV
thaini	CV-CV
kxiito	CCV-CV
whatai	CV-CV
kthaetii	CCV-CV
zhani	CV-CV
waezhai	CV-CV
laga	CV-CV
ghaizae	CV-CV
zaemhe	CV-CV
smomhi	CCV-CV
ziitai	CV-CV
kthowha	CCV-CV
tshedii	CV-CV
mhamai	CV-CV
zhatshii	CV-CV
mr*alhai	CCV-CV
smaiwhae	CCV-CV
nhaidhai	CV-CV
gainae	CV-CV
mr*aezhii	CCV-CV
nraengo	CCV-CV
mr*etsha	CCV-CV
xiinga	CV-CV
kxaishai	CCV-CV
mronghai	CCV-CV
maini	CV-CV
widhii	CV-CV
gotshai	CV-CV
mlaegi	CCV-CV
mrawhii	CCV-CV
nhaere	CV-CV
r*aisho	CV-CV
mralhii	CCV-CV
nhowho	CV-CV
ghegai	CV-CV
mlaizhae	CCV-CV
xainghai	CV-CV
waemhe	CV-CV
nlaezai	CCV-CV
whigo	CV-CV
thiitshae	CV-CV
kxaidhi	CCV-CV
whalhi	CV-CV
thedhai	CV-CV
lhaeko	CV-CV
lhozhae	CV-CV
tshaira	CV-CV
zenghe	CV-CV
ngedhii	CV-CV
kthaewii	CCV-CV
nr*iithe	CCV-CV
daisha	CV-CV
ksizae	CCV-CV
tshiime	CV-CV
snhekae	CCV-CV
maithe	CV-CV
nghaezae	CV-CV
kxatshe	CCV-CV
r*aethae	CV-CV
komhai	CV-CV
losai	CV-CV
memhii	CV-CV
thwhiizho	CCV-CV
tshaisha	CV-CV
mhaidhi	CV-CV
nr*ainhai	CCV-CV
thwhaidi	CCV-CV
xaitii	CV-CV
mraenghai	CCV-CV
thwhaeno	CCV-CV
snote	CCV-CV
lemho	CV-CV
nhaimhi	CV-CV
dika	CV-CV
xana	CV-CV
thwhasai	CCV-CV
mradhae	CCV-CV
raizhai	CV-CV
liighae	CV-CV
kthitshai	CCV-CV
tsarae	CCV-CV
ghaezhai	CV-CV
naenae	CV-CV
mhainho	CV-CV
thonge	CV-CV
ngoshii	CV-CV
kxedhi	CCV-CV
diitho	CV-CV
mrainhi	CCV-CV
nrongai	CCV-CV
lhasha	CV-CV
mhonhe	CV-CV
naitshai	CV-CV
tiwa	CV-CV
smemii	CCV-CV
waigii	CV-CV
nr*itii	CCV-CV
gaingai	CV-CV
snhaili	CCV-CV
xaezhai	CV-CV
zheme	CV-CV
whogo	CV-CV
keno	CV-CV
liigi	CV-CV
r*omhae	CV-CV
smaithi	CCV-CV
snainge	CCV-CV
mlothai	CCV-CV
smaethai	CCV-CV
raide	CV-CV
thwhowai	CCV-CV
kxesho	CCV-CV
tsodhae	CCV-CV
maedhii	CV-CV
ksinai	CCV-CV
sogai	CV-CV
ksedi	CCV-CV
whiiza	CV-CV
xaenghe	CV-CV
ksairi	CCV-CV
nhishai	CV-CV
daide	CV-CV
tshailii	CV-CV
mr*air*ae	CCV-CV
waimhai	CV-CV
zaingae	CV-CV
zotshae	CV-CV
lotha	CV-CV
nr*aidhae	CCV-CV
mrimo	CCV-CV
snaira	CCV-CV
nler*ae	CCV-CV
kaini	CV-CV
tsiishae	CCV-CV
ksolai	CCV-CV
tsiidhii	CCV-CV
sonhii	CV-CV
siinghai	CV-CV
waixii	CV-CV
lengha	CV-CV
gainghai	CV-CV
gaimii	CV-CV
sogho	CV-CV
zhoda	CV-CV
mhaethi	CV-CV
nr*edo	CCV-CV
ghoka	CV-CV
kthiigae	CCV-CV
r*iiwhai	CV-CV
snoxai	CCV-CV
mhaisi	CV-CV
zhiite	CV-CV
dhongo	CV-CV
mr*emhai	CCV-CV
mr*ithai	CCV-CV
xikai	CV-CV
lhedha	CV-CV
snailhi	CCV-CV
nlezhii	CCV-CV
latshai	CV-CV
ghaidhae	CV-CV
raimha	CV-CV
laera	CV-CV
zozhai	CV-CV
mhaingo	CV-CV
kxaiwho	CCV-CV
r*airii	CV-CV
kximae	CCV-CV
nhaiwi	CV-CV
zhaidhii	CV-CV
mralhae	CCV-CV
ksemii	CCV-CV
r*ame	CV-CV
dar*ai	CV-CV
retsho	CV-CV
r*enhe	CV-CV
lidho	CV-CV
mr*aer*ai	CCV-CV
nriilii	CCV-CV
r*aingi	CV-CV
mlili	CCV-CV
mhiwi	CV-CV
nraixii	CCV-CV
ghaela	CV-CV
mlexe	CCV-CV
kaenghai	CV-CV
daighe	CV-CV
taiwi	CV-CV
nhainhi	CV-CV
giiwe	CV-CV
thizhe	CV-CV
riwha	CV-CV
mregi	CCV-CV
mliiwae	CCV-CV
smhaemo	CCV-CV
sainghii	CV-CV
mrera	CCV-CV
siixe	CV-CV
tshozo	CV-CV
lhala	CV-CV
xaga	CV-CV
garo	CV-CV
whiimhai	CV-CV
nghaedhai	CV-CV
zaethai	CV-CV
tshothii	CV-CV
ghaetho	CV-CV
r*ar*a	CV-CV
nghainghai	CV-CV
sona	CV-CV
saza	CV-CV
ghedhae	CV-CV
mr*aimai	CCV-CV
nrainghai	CCV-CV
taitsho	CV-CV
smhitshe	CCV-CV
nghaxi	CV-CV
tshetae	CV-CV
kimhai	CV-CV
whitai	CV-CV
lhasho	CV-CV
mlaelhai	CCV-CV
xir*o	CV-CV
rainha	CV-CV
nainghii	CV-CV
smhaighii	CCV-CV
ghewhe	CV-CV
lhidii	CV-CV
nregai	CCV-CV
thaewhai	CV-CV
r*idai	CV-CV
molii	CV-CV
tsize	CCV-CV
nghelae	CV-CV
seshe	CV-CV
kati	CV-CV
thwhaetshai	CCV-CV
ksiingae	CCV-CV
snhanhe	CCV-CV
ksiike	CCV-CV
ghaitshae	CV-CV
smaengai	CCV-CV
kthiighi	CCV-CV
smair*e	CCV-CV
tshairae	CV-CV
shiingho	CV-CV
ghaiko	CV-CV
lhazha	CV-CV
nhoghii	CV-CV
smizii	CCV-CV
nazhi	CV-CV
lhexai	CV-CV
whiikai	CV-CV
ksalhai	CCV-CV
snailai	CCV-CV
lhaeghi	CV-CV
maghe	CV-CV
nlotshae	CCV-CV
ksaina	CCV-CV
kthiizi	CCV-CV
ngheghai	CV-CV
shaele	CV-CV
snhaewai	CCV-CV
smhowae	CCV-CV
raenhii	CV-CV
waizai	CV-CV
snomai	CCV-CV
ngiikai	CV-CV
nraiwhae	CCV-CV
giiro	CV-CV
wholo	CV-CV
snhote	CCV-CV
smaisii	CCV-CV
tiitsho	CV-CV
xeshae	CV-CV
naile	CV-CV
shizha	CV-CV
mrengai	CCV-CV
xelhe	CV-CV
ksowhae	CCV-CV
tsair*ai	CCV-CV
ngekai	CV-CV
kxaewhai	CCV-CV
rizi	CV-CV
ghaingi	CV-CV
mlaishi	CCV-CV
thwhailai	CCV-CV
gonghe	CV-CV
nginge	CV-CV
smhaisa	CCV-CV
ksaexo	CCV-CV
thizai	CV-CV
mlaile	CCV-CV
tshashe	CV-CV
whiigai	CV-CV
mlaenha	CCV-CV
snhighi	CCV-CV
lor*ii	CV-CV
thixii	CV-CV
lhodhai	CV-CV
whaize	CV-CV
snomhe	CCV-CV
kxaewhae	CCV-CV
taenghi	CV-CV
zhaito	CV-CV
snherai	CCV-CV
nlainga	CCV-CV
mhaezai	CV-CV
ghaele	CV-CV
